10 10
57 02 02 02 02 02 02 02 02 58
65 10 10 10 10 10 10 10 10 66
65 34 34 34 34 34 34 34 34 66
65 34 34 34 34 34 34 34 34 66
65 34 34 34 34 34 34 34 34 66
65 34 34 34 34 34 34 34 34 66
65 34 34 34 34 34 34 34 34 66
65 34 34 34 34 34 34 34 34 66
65 34 34 34 34 34 34 34 34 66
73 83 83 83 83 83 83 83 83 74
